4 4 4 4 4 4 4 4 4 4 4 4 4 4 4 9 4
4 4 4 4 4 4 4 7 8 4 4 4 4 4 4 4 4
4 4 4 4 4 4 4 4 4 4 4 4 4 4 4 4 4
4 4 4 4 4 4 4 4 4 4 4 4 4 4 7 8 4
0 1 0 1 1 0 0 3 0 1 0 1 0 0 1 2 2
4 4 4 4 4 4 4 4 4 4 4 4 4 4 4 4 4